+-+-+-+-+-+-+-+-+-+-+-+-+-+-+-+-+-+-+-+-+-+-+-+-+-+
| |                                               |
+ +-+-+ + + + +-+ + +-+ +-+-+-+-+ +-+-+ + + +-+-+ +
| |   | | | |                           | |     | |
+ + + +-+ + +-+-+-+-+ +-+-+-+ + +-+ +-+-+ +-+-+ + +
| | |                                             |
+ + +-+ + +-+ + +-+ +-+-+-+ +-+-+ +-+ +-+-+ +-+-+ +
| |   | |                                         |
+ +-+ + +-+-+-+ +-+-+-+-+-+-+-+ +-+-+-+ +-+-+ +-+-+
|   | |       | |                           | |   |
+-+ + +-+-+-+ +-+ +-+-+-+ + +-+-+ +-+-+-+-+ + + + +
| |         | |                                 | |
+ +-+-+ +-+ + + +-+ +-+ +-+-+-+ +-+-+-+-+ + +-+-+ +
|                                         | |     |
+ +-+ +-+-+-+-+-+ +-+ +-+ +-+-+-+ +-+-+-+-+-+ +-+-+
|                                                 |
+-+ +-+-+-+-+-+ + + +-+ + + +-+-+ + +-+ + +-+-+ +-+
|             | | | |   | | |   | | | |           |
+ +-+ +-+ + + + +-+ + +-+ + + +-+ + + +-+-+ + +-+ +
| | |   | | | |         | | |                     |
+ + + + +-+ + +-+-+-+-+-+ + + + +-+-+-+-+ +-+-+-+ +
| |                       | | |                   |
+ +-+ +-+-+-+-+-+ +-+-+-+-+ + + + + +-+-+-+ +-+-+ +
|                         | | | |               | |
+-+ +-+-+ + +-+-+-+ +-+ + + + + +-+ + + +-+-+ + + +
|                           | | |   | | |     | | |
+ +-+-+-+-+ + +-+ +-+ +-+-+-+-+ +-+-+ + + +-+-+ + +
|         | |                                 | | |
+-+-+ + + +-+ + +-+-+-+ +-+ + +-+-+ +-+-+-+ + + + +
|           | |     | | |                 | | | | |
+-+ +-+-+-+ + +-+-+ + + + +-+-+-+ +-+-+-+ +-+ + + +
|         | |     | | |                       | | |
+ + +-+ + + +-+ +-+ + +-+-+ +-+-+-+ + + +-+-+ + +-+
| |   | | | |             | |       | |     | |   |
+ +-+ + +-+ + +-+ +-+-+ + + + +-+-+-+ +-+-+ + +-+ +
| |   | |   | | | |     | | | |           | | |   |
+ + +-+ + +-+ + + + + +-+ + + +-+ +-+-+ +-+ +-+ + +
| |     | | |   | | | | | | |                   | |
+ +-+-+-+ + +-+ + + + + + + +-+ + + + +-+-+-+-+-+ +
|       | |     | | | |       | | | |             |
+ +-+-+ + + +-+-+ + + +-+-+-+-+ + + +-+-+-+ + +-+ +
| |       | |     | |           | | |           | |
+ + +-+-+-+-+ +-+-+ +-+-+-+-+-+-+ + + +-+-+-+-+ +-+
| |               | |           | | |             |
+ +-+ +-+-+-+-+ +-+ + +-+-+-+ +-+ + +-+ +-+ + +-+ +
|                                                 |
+-+-+-+ +-+ +-+-+-+-+ +-+ + +-+ +-+-+-+-+ +-+-+-+ +
| |                 | |                         | |
+ + + + + +-+ +-+ + +-+ +-+-+ +-+-+-+ + +-+ + +-+ +
|                                                 |
+-+-+-+-+-+-+-+-+-+-+-+-+-+-+-+-+-+-+-+-+-+-+-+-+-+
